wwwwwww-wwwwwwwww
w---w------w----w
w-www-w-ww-w-ww-w
w-w---w-w----w--w
w-w-w-w-wwwwwwwww
w-w-www-w-------w
w-w---w-w-wwwww-w
w-www-w-------w-w
w-----wwwwwww-w-w
w-w-w-w-------w-w
wwwwwww-wwwwwwwww