wwwww-wwwww
w-----w---w
w-www---w-w
w-w-wwwww-w
w-w-w-w---w
w-w-w-w-www
w-w---w---w
w-w-wwwww-w
w---w-----w
wwwww-wwwww